#####################
#####################
#...................#
#.#.###..###..###.#.##
#.................#.##
#.#.###.#####.###.#.##
#.#.....#...#.....#.##
#.#####.#.#.#####.#.##
#.#.....###.....#.#.##
#.#.###..###..###...##
#.#................##
#.###.########.###.##
#.....##.....##.....##
#.###.#####.###.#.#.##
#.#.........#.....#.##
#.#.###.###.###.#.#.##
#.......#.#.......#.##
###..##.#.###.####..#
#...........#......###
##..#######...###...##
#..................##
#####################